111111111111111111111111111111111
1C10000000P0000000000000000000011
100000000000000000111100000000001
100011E0000C00000C000000111100001
111111111111111111111111111111111